				"□□□□□□□□□□□□□□□□□□□□□□□□□□□□□□□□□□□□□□□",
				"□□□□□□□□□□□□□□□□□□□□□□□□□□□□□□□□□□□□□□□",
				"□□■■■■■■■■■■■■■■■■■■■■■■■■■■■■■■■■■■■□□",
				"□□■→□□□□□□■□□□■□□□□□□□□□■□□□□□■□□□□□■□□",
				"□□■□■■■■■△■□■□■■■□■■■■■■■□■□■■■■■□■□■□□",
				"□□■□□□■□□□□□■□□□□□□□□□□□□□■□□□□□□□■□■□□",
				"□□■□■■■□■■■■■□■□■■■■■□■■■■■■■□■■■■■□■□□",
				"□□■□■□□□□□□□■□■□□□□□■□□□□□□□■□□□■□□□■□□",
				"□□■□■△■■■■■■■■■■■■■□■■■■■□■■■□■■■■■■■□□",
				"□□■□■□□□□□□□□□■□□□□□□□□□■□□□■□□□□□□□■□□",
				"□□■□■■■□■■■■■□■■■■■■■□■■■□■□■■■□■□■□■□□",
				"□□■□□□■□■□□□□□□□■□□□□□□□■□■□□□■□■□■□■□□",
				"□□■□■■■■■□■□■□■■■■■□■□■■■■■□■□■■■■■□■□□",
				"□□■□□□■□□□■□■□□□□□■□■□□□■□□□■□□□□□■□■□□",
				"□□■■■■■△■■■■■■■■■□■■■■■□■■■■■□■■■■■□■□□",
				"□□■□□□□□□□□□□□□□■□□□□□■□□□■□□□□□□□■□■□□",
				"□□■□■□■■■■■□■■■■■■■■■■■□■■■□■■■■■■■□■□□",
				"□□■□■□□□■□□□□□□□□□□□□□■□□□■□□□■□□□□□■□□",
				"□□■□■□■■■□■□■■■■■□■△■■■□■■■■■□■■■□■■■□□",
				"□□■□■□■□□□■□□□□□■□■□□□■□■□□□□□■□□□□□■□□",
				"□□■■■□■■■■■□■□■■■■■■■△■■■■■■■■■■■□■□■□□",
				"□□■□□□□□■□□□■□■□□□□□□□■□□□□□□□□□□□■□■□□",
				"□□■□■■■■■□■□■□■□■□■■■■■■■■■□■■■■■□■□■□□",
				"□□■□□□□□■□■□■□■□■□□□□□□□■□□□□□□□■□■□■□□",
				"□□■■■□■□■□■■■□■□■■■■■■■■■■■□■□■□■■■■■□□",
				"□□■□□□■□■□■□□□■□□□□□□□□□□□■□■□■□□□□□■□□",
				"□□■□■■■■■■■■■■■□■□■□■■■■■□■■■■■□■□■□■□□",
				"□□■□□□□□□□■□□□□□■□■□□□■□□□□□□□■□■□■□■□□",
				"□□■□■□■■■■■□■□■■■■■□■■■■■□■■■□■□■□■□■□□",
				"□□■□■□□□□□■□■△☆☆☆△■□□□□□■□□□■□■□■□■□■□□",
				"□□■■■■■■■■■■■■■□■□■■■■■■■■■□■■■□■■■□■□□",
				"□□■□□□□□□□□□□□□□■□□□□□□□□□■□□□■□□□■□■□□",
				"□□■■■□■■■■■■■■■□■■■■■□■■■■■■■■■■■■■■■□□",
				"□□■□□□□□□□□□□□■□□□■□□□□□□□□□□□□□△□□□■□□",
				"□□■□■■■□■■■□■□■■■■■■■□■■■■■■■□■■■△■□■□□",
				"□□■□□□■□■□□□■□□□□□□□■□□□■□□□□□■□□□■□■□□",
				"□□■■■■■■■■■■■■■■■■■■■■■■■■■■■■■■■♧■■■□□",
				"□□□□□□□□□□□□□□□□□□□□□□□□□□□□□□□□□□□□□□□",
				"□□□□□□□□□□□□□□□□□□□□□□□□□□□□□□□□□□□□□□□"