				"□□□□□□□□□□□□□□□□□□□□□□□□□□□□□□□□□□□□□□□",
				"□□□□□□□□□□□□□□□□□□□□□□□□□□□□□□□□□□□□□□□",
				"□□■■■■■■■■■■■■■■■■■■■■■■■■■■■■■■■■■■■□□",
				"□□■→□□□□□□■□□□■□□□□□□□□□■□□□□□■□□□□□■□□",
				"□□■□■■■■■□■□■□■■■□■■■■■■■□■□■■■■■□■□■□□",
				"□□■□□□■□□□□□■□□□□□□□□□□□□□■□□□□□□□■□■□□",
				"□□■□■■■□■■■■■□■□■■■■■□■■■■■■■□■■■■■□■□□",
				"□□■□■□□□□□□□■□■□□□□□■□□□□□□□■□□□■□□□■□□",
				"□□■□■□■■■■■■■■■■■■■□■■■■■□■■■□■■■■■■■□□",
				"□□■□■□□□□□□□□□■□□□□□□□□□■□□□■□□□□□□□■□□",
				"□□■□■■■□■■■■■□■■■■■■■□■■■□■□■■■□■□■□■□□",
				"□□■□□□■□■□□□□□□□■□□□□□□□■□■□□□■□■□■□■□□",
				"□□■□■■■■■□■□■□■■■■■□■□■■■■■□■□■■■■■□■□□",
				"□□■□□□■□□□■□■□□□□□■□■□□□■□□□■□□□□□■□■□□",
				"□□■■■■■□■■■■■■■■■□■■■■■□■■■■■□■■■■■□■□□",
				"□□■□□□□□□□□□□□□□■□□□□□■□□□■□□□□□□□■□■□□",
				"□□■□■□■■■■■□■■■■■■■■■■■□■■■□■■■■■■■□■□□",
				"□□■□■□□□■□□□□□□□□□□□□□■□□□■□□□■□□□□□■□□",
				"□□■□■□■■■□■□■■■■■□■□■■■□■■■■■□■■■□■■■□□",
				"□□■□■□■□□□■□□□□□■□■□□□■□■□□□□□■□□□□□■□□",
				"□□■■■□■■■■■□■□■■■■■■■□■■■■■■■■■■■□■□■□□",
				"□□■□□□□□■□□□■□■□□□□□□□■□□□□□□□□□□□■□■□□",
				"□□■□■■■■■□■□■□■□■□■■■■■■■■■□■■■■■□■□■□□",
				"□□■□□□□□■□■□■□■□■□□□□□□□■□□□□□□□■□■□■□□",
				"□□■■■□■□■□■■■□■□■■■■■■■■■■■□■□■□■■■■■□□",
				"□□■□□□■□■□■□□□■□□□□□□□□□□□■□■□■□□□□□■□□",
				"□□■□■■■■■■■■■■■□■□■□■■■■■□■■■■■□■□■□■□□",
				"□□■□□□□□□□■□□□□□■□■□□□■□□□□□□□■□■□■□■□□",
				"□□■□■□■■■■■□■□■■■■■□■■■■■□■■■□■□■□■□■□□",
				"□□■□■□□□□□■□■□□□□□■□□□□□■□□□■□■□■□■□■□□",
				"□□■■■■■■■■■■■■■□■□■■■■■■■■■□■■■□■■■□■□□",
				"□□■□□□□□□□□□□□□□■□□□□□□□□□■□□□■□□□■□■□□",
				"□□■■■□■■■■■■■■■□■■■■■□■■■■■■■■■■■■■■■□□",
				"□□■□□□□□□□□□□□■□□□■□□□□□□□□□□□□□□□□□■□□",
				"□□■□■■■□■■■□■□■■■■■■■□■■■■■■■□■■■□■□■□□",
				"□□■□□□■□■□□□■□□□□□□□■□□□■□□□□□■□□□■□■□□",
				"□□■■■■■■■■■■■■■■■■■■■■■■■■■■■■■■■♧■■■□□",
				"□□□□□□□□□□□□□□□□□□□□□□□□□□□□□□□□□□□□□□□",
				"□□□□□□□□□□□□□□□□□□□□□□□□□□□□□□□□□□□□□□□"